NO ./textures/test/north_wall.xpm
SO ./textures/test/south_wall.xpm
WE ./textures/test/west_wall.xpm
EA ./textures/test/east_wall.xpm

F 28,8,0
C 135,206,235

     11111111111     
     10001110001     
111111000010000111111
100000000000000000001
110000000000000000011
1110000000W0000000111
110000000000000000011
100000000000000000001
111111000010000111111
     10001110001     
     11111111111     
