NO ./textures/north_wall.xpm
SO ./textures/south_wall.xpm
WE ./textures/west_wall.xpm
EA ./textures/east_wall.xpm

F 220,100,0
C 225,30,0

        1111111111111
        1000000000001
        1000000110001
        10000N0110001
111111111000000000001
100000000000011110001
100111000000011110001
100000000000000000001
111111111111111111111
