NO ./textures/dracula/north_wall.xpm
SO ./textures/dracula/south_wall.xpm
WE ./textures/dracula/west_wall.xpm
EA ./textures/dracula/east_wall.xpm

F 52, 58, 64
C 32, 32, 32

111111111111111111111
1N0100000010000000001
101101111010111111101
100000001010100000101
111111101010101110101
100000101000001000001
101110101111101011111
101000100000101000001
101011111110101111101
101000000010100000001
101111111011101111101
100000000000001000001
111111111111111111111