NO ./textures/submarine/north_wall.xpm
SO ./textures/submarine/south_wall.xpm
WE ./textures/submarine/west_wall.xpm
EA ./textures/submarine/east_wall.xpm

F 0, 165, 207
C 37, 161, 142

1111111
1100011
1011101
1N01101
1110111