NO ./textures/test/north_wall.xpm
SO ./textures/test/south_wall.xpm
WE ./textures/test/west_wall.xpm
EA ./textures/test/east_wall.xpm

F 28,8,0
C 135,206,235

        1111111111111
        1000000000001
        1001000110001
        10010001100E1
111111111000000000001
100000000000011110001
100111000101010010001
100000000000000000001
111111111111111111111
